1111111111111
1011110000101
1001001111001
10010100000N0
1111111111011