1111111111111
1000000000101
1001101100001
100N100010011
1000000000011
1111111111111